00000000
00000000
00000000
10000000
11020011
11111111
11111111